0 0 0 0 0 0 0 0 0 0
0 0 0 0 0 0 0 0 0 0
0 0 0 0 0 0 0 0 0 0
11 11 11 11 11 11 11 0 0 0
10 10 10 10 10 9 11 0 0 0
23 10 10 10 10 10 11 0 0 0
11 11 11 12 10 10 11 0 0 0
0 0 0 11 10 10 11 0 0 0
0 0 0 11 10 10 11 0 0 0
0 0 0 11 22 22 11 0 0 0
0 4 0 0 0 0 0 0 0 0
10 0 0 0 0 0 0 0 0 0
9 4 0 0 0 0 0 0 0 0
0 0 0 0 0 0 0 0 0 0
0 0 0 0 0 0 0 0 0 0
0 0 0 0 0 0 0 0 0 0
0 0 0 0 0 0 0 0 0 0
0 0 0 0 0 0 0 0 0 0
0 0 0 0 0 0 0 0 0 0
