0 0 0 11 10 10 11 0 0 0
0 0 11 13 10 10 13 11 0 0
0 11 10 11 10 10 11 0 0 0
11 13 11 13 10 10 13 11 0 0
23 10 10 10 10 10 11 0 0 0
23 10 10 10 10 10 11 0 0 0
11 13 11 11 11 11 11 0 0 0
0 11 0 0 0 0 0 0 0 0
0 0 0 0 0 0 0 0 0 0
0 0 0 0 0 0 0 0 0 0
0 0 0 0 0 0 0 0 0 0
0 0 0 0 0 0 0 0 0 0
9 10 0 0 0 0 0 0 0 0
0 0 0 0 0 0 0 0 0 0
0 0 0 0 0 0 0 0 0 0
0 0 0 0 0 0 0 0 0 0
0 0 0 0 0 0 0 0 0 0
0 0 0 0 0 0 0 0 0 0
0 0 0 0 0 0 0 0 0 0
