0 0 0 11 24 24 11 0 0 0
0 0 11 12 10 10 11 0 0 0
0 0 11 12 10 10 11 0 0 0
0 0 0 11 10 10 11 11 11 11
0 0 0 11 10 10 10 10 10 10
0 0 0 11 10 10 10 10 10 10
0 0 0 11 11 11 11 11 11 11
0 0 0 0 0 0 0 0 0 0
0 0 0 0 0 0 0 0 0 0
0 0 0 0 0 0 0 0 0 0
0 0 0 0 0 0 0 0 0 0
0 0 0 0 0 0 0 0 0 0
0 0 0 0 0 0 0 0 0 0
10 9 0 0 0 0 0 0 0 0
0 0 0 0 0 0 0 0 0 0
0 0 0 0 0 0 0 0 0 0
0 0 0 0 0 0 0 0 0 0
0 0 0 0 0 0 0 0 0 0
0 0 0 0 0 0 0 0 0 0
