0 0 0 0 0 0 0 0 0 0
0 0 0 0 0 0 0 0 0 0
0 0 0 0 0 0 0 0 0 0
0 0 0 11 11 11 11 11 11 11
0 0 0 11 10 10 2 10 6 21
0 0 0 11 10 10 2 10 6 21
0 0 0 11 2 2 11 11 11 11
0 0 0 11 10 10 11 0 0 0
0 0 0 11 2 2 11 0 0 0
0 0 0 11 10 10 11 0 0 0
0 10 0 0 0 0 0 0 0 0
0 0 0 0 0 0 0 0 0 0
0 0 0 0 0 0 0 0 0 0
0 0 0 0 0 0 0 0 0 0
0 0 0 0 0 0 0 0 0 0
0 0 0 0 0 0 0 0 0 0
0 0 0 0 0 0 0 0 0 0
0 0 0 0 0 0 0 0 0 0
0 0 0 0 0 0 0 0 0 0
