2 2 2 2 2 2 2 2 2 2
2 7 7 7 7 7 7 7 7 2
2 7 7 7 7 7 7 7 7 2
2 7 7 7 7 7 7 7 7 2
2 7 7 7 7 7 7 7 7 2
2 7 7 7 7 7 7 7 7 2
2 7 7 7 7 7 7 7 7 2
2 7 7 7 7 7 7 7 7 2
2 7 7 7 7 7 7 7 7 2
2 2 2 2 2 2 2 2 2 2
1 1 0 0 0 0 0 0 0 0
0 0 0 0 0 0 0 0 0 0
0 0 0 0 0 0 0 0 0 0
0 0 0 0 0 0 0 0 0 0
0 0 0 0 0 0 0 0 0 0
0 0 0 0 0 0 0 0 0 0
0 0 0 0 0 0 0 0 0 0
0 0 0 0 0 0 0 0 0 0
0 0 0 0 0 0 0 0 0 0
