1 1 1 1 5 11 10 10 10 11
1 1 1 1 5 11 10 10 10 11
1 1 1 5 11 10 10 10 10 11
1 1 5 5 11 10 10 10 11 0
5 5 11 11 10 10 10 10 11 0
11 11 10 10 10 10 10 11 0 0
-3 10 10 10 10 10 10 11 0 0
-3 10 10 10 10 11 11 0 0 0
-3 10 10 11 11 0 0 0 0 0
11 11 11 0 0 0 0 0 0 0
0 0 0 0 0 0 0 0 0 0
0 0 0 0 0 0 0 0 0 0
9 10 0 0 0 0 0 0 0 0
0 0 0 0 0 0 0 0 0 0
0 0 0 0 0 0 0 0 0 0
0 0 0 0 0 0 0 0 0 0
0 0 0 0 0 0 0 0 0 0
0 0 0 0 0 0 0 0 0 0
0 0 0 0 0 0 0 0 0 0
