0 0 0 0 0 0 0 11 11 11
0 0 0 0 0 11 11 10 9 -1
0 0 0 11 11 10 10 10 10 -1
0 0 12 10 10 10 10 10 9 -1
0 0 11 10 10 10 10 10 11 11
0 13 10 10 10 11 12 11 5 5
0 11 10 10 10 11 5 5 1 1
11 10 10 13 10 11 5 1 1 1
11 10 10 10 11 5 1 1 1 1
11 10 10 10 11 5 1 1 1 1
0 10 0 0 0 0 0 0 0 0
0 0 0 0 0 0 0 0 0 0
0 0 0 0 0 0 0 0 0 0
0 0 0 0 0 0 0 0 0 0
0 0 0 0 0 0 0 0 0 0
0 0 0 0 0 0 0 0 0 0
0 0 0 0 0 0 0 0 0 0
0 0 0 0 0 0 0 0 0 0
0 0 0 0 0 0 0 0 0 0
