11 -4 -4 -4 11 5 1 1 1 1
11 10 10 10 11 5 1 1 1 1
11 10 10 10 10 11 5 1 1 1
0 11 10 10 10 11 5 5 1 1
0 11 10 10 10 10 11 11 5 5
0 0 11 10 10 10 10 10 11 11
0 0 11 10 10 10 10 10 10 10
0 0 0 11 11 10 10 10 10 10
0 0 0 0 0 11 11 10 10 10
0 0 0 0 0 0 0 11 11 11
0 0 0 0 0 0 0 0 0 0
0 0 0 0 0 0 0 0 0 0
0 0 0 0 0 0 0 0 0 0
10 9 0 0 0 0 0 0 0 0
0 0 0 0 0 0 0 0 0 0
0 0 0 0 0 0 0 0 0 0
0 0 0 0 0 0 0 0 0 0
0 0 0 0 0 0 0 0 0 0
0 0 0 0 0 0 0 0 0 0
