3 3 3 25 3 3 3 25 2 2 
3 25 3 25 3 25 3 25 2 2
3 9 3 25 3 9 3 25 2 2
3 25 3 3 3 25 3 25 2 2
5 25 25 25 25 25 3 25 2 2
5 25 2 2 2 25 3 25 2 2
6 25 2 2 25 25 3 9 2 2
25 25 2 2 25 3 3 25 2 2
2 2 2 2 4 3 4 25 2 2
2 2 2 2 4 22 4 2 2 2
0 4 0 0 0 0 0 0 0 0
10 0 0 0 0 0 0 0 0 0 
0 0 0 0 0 0 0 0 0 0
0 0 0 0 0 0 0 0 0 0
10 10 0 0 0 0 0 0 0 0
0 0 0 0 0 0 0 0 0 0
0 0 0 0 0 0 0 0 0 0
0 0 0 0 0 0 0 0 0 0
0 0 0 0 0 0 0 0 0 0
