2 2 2 25 7 7 25 2 2 2 
2 2 2 25 7 7 25 2 2 2 
2 2 2 25 7 7 25 2 2 2 
8 8 25 25 7 7 25 2 2 2 
23 7 7 7 7 7 25 2 2 2 
23 7 7 7 7 9 25 2 2 2 
8 8 25 25 25 25 25 2 2 2 
2 2 2 2 2 2 2 2 2 2 
2 2 2 2 2 2 2 2 2 2 
2 2 2 2 2 2 2 2 2 2 
0 0 0 0 0 0 0 0 0 0
0 0 0 0 0 0 0 0 0 0
9 10 0 0 0 0 0 0 0 0
0 0 0 0 0 0 0 0 0 0
10 10 0 0 0 0 0 0 0 0
0 0 0 0 0 0 0 0 0 0
0 0 0 0 0 0 0 0 0 0
0 0 0 0 0 0 0 0 0 0
0 0 0 0 0 0 0 0 0 0
