2 2 2 4 24 24 4 2 2 2 
2 2 2 4 3 3 4 2 2 2 
2 2 2 25 3 9 25 2 2 2 
2 2 2 25 3 3 25 25 25 25 
2 2 2 25 3 3 3 9 3 3 
2 2 2 25 9 3 3 3 3 3 
2 2 2 25 25 25 25 25 25 25 
2 2 2 2 2 2 2 2 2 2 
2 2 2 2 2 2 2 2 2 2 
2 2 2 2 2 2 2 2 2 2 
0 0 0 0 0 0 0 0 0 0 
0 0 0 0 0 0 0 0 0 0
0 0 0 0 0 0 0 0 0 0
10 9 0 0 0 0 0 0 0 0
10 10 0 0 0 0 0 0 0 0
0 0 0 0 0 0 0 0 0 0
0 0 0 0 0 0 0 0 0 0
0 0 0 0 0 0 0 0 0 0
0 0 0 0 0 0 0 0 0 0