2 2 2 2 2 2 2 2 2 2 
2 2 2 2 2 2 2 2 2 2 
2 2 2 2 2 2 2 2 2 2 
2 2 2 25 25 25 25 25 4 4 
2 2 2 25 2 2 2 2 2 21 
2 2 2 25 2 2 2 2 2 21 
2 2 2 25 2 2 25 25 4 4 
2 2 2 25 2 2 25 2 2 2 
2 2 2 25 2 2 25 2 2 2 
2 2 2 9 3 3 9 2 2 2 
0 10 0 0 0 0 0 0 0 0
0 0 0 0 0 0 0 0 0 0
0 0 0 0 0 0 0 0 0 0
0 0 0 0 0 0 0 0 0 0
10 10 0 0 0 0 0 0 0 0
0 0 0 0 0 0 0 0 0 0
0 0 0 0 0 0 0 0 0 0
0 0 0 0 0 0 0 0 0 0
0 0 0 0 0 0 0 0 0 0
