11 11 11 0 0 0 0 0 0 0
10 10 10 11 11 0 0 0 0 0
10 10 10 10 10 11 11 0 0 0
10 10 10 10 10 10 13 11 0 0
11 11 10 10 10 10 10 11 0 0
5 5 11 11 12 10 10 10 11 0
1 1 5 5 11 10 10 10 11 0
1 1 1 5 11 10 10 10 10 11
1 1 1 1 5 11 10 10 10 11
1 1 1 1 5 11 -2 -2 -2 11
0 1 0 0 0 0 0 0 0 0
10 0 0 0 0 0 0 0 0 0
0 0 0 0 0 0 0 0 0 0
0 0 0 0 0 0 0 0 0 0
0 0 0 0 0 0 0 0 0 0
0 0 0 0 0 0 0 0 0 0
0 0 0 0 0 0 0 0 0 0
0 0 0 0 0 0 0 0 0 0
0 0 0 0 0 0 0 0 0 0
