11 -4 -4 -4 11 5 1 1 1 1
11 2 10 2 11 5 1 1 1 1
11 2 10 2 2 11 5 1 1 1
0 2 10 10 2 11 5 5 1 1
0 11 9 10 2 2 11 2 5 5
0 0 11 10 2 10 10 10 11 11
0 0 2 10 10 10 9 10 2 2
0 0 0 11 11 2 2 10 2 2
0 0 0 0 0 11 2 10 10 10
0 0 0 0 0 0 0 11 11 11
0 0 0 0 0 0 0 0 0 0
0 0 0 0 0 0 0 0 0 0
0 0 0 0 0 0 0 0 0 0
10 9 0 0 0 0 0 0 0 0
0 0 0 0 0 0 0 0 0 0
0 0 0 0 0 0 0 0 0 0
0 0 0 0 0 0 0 0 0 0
0 0 0 0 0 0 0 0 0 0
0 0 0 0 0 0 0 0 0 0
