8 8 8 8 8 8 8 8 8 8
8 8 8 8 8 8 8 8 8 8
-4 5 7 7 7 7 7 7 8 8
-4 5 7 7 7 7 7 7 8 8
-4 5 7 7 7 7 7 7 8 8
-4 5 7 7 7 7 7 7 8 8
-4 5 7 7 7 7 7 7 8 8
-4 5 7 7 7 7 7 7 8 8
8 8 7 7 7 7 7 7 8 8
8 8 -2 -2 -2 -2 -2 -2 8 8
1 2 0 0 0 0 0 0 0 0
10 1 0 0 0 0 0 0 0 0
0 0 0 0 0 0 0 0 0 0
8 10 0 0 0 0 0 0 0 0
0 0 0 0 0 0 0 0 0 0
0 0 0 0 0 0 0 0 0 0
0 0 0 0 0 0 0 0 0 0
0 0 0 0 0 0 0 0 0 0
0 0 0 0 0 0 0 0 0 0
