8 8 -1 -1 -1 -1 -1 -1 8 8
8 8 7 7 7 7 7 7 8 8
-3 7 7 7 7 7 7 7 8 8
-3 7 7 7 7 7 7 7 8 8
-3 7 7 7 7 7 7 7 8 8
-3 7 7 7 7 7 7 7 8 8
-3 7 7 7 7 7 7 7 8 8
-3 7 7 7 7 7 7 7 8 8
8 8 8 8 8 8 8 8 8 8
8 8 8 8 8 8 8 8 8 8
10 8 0 0 0 0 0 0 0 0
0 0 0 0 0 0 0 0 0 0
8 10 0 0 0 0 0 0 0 0
0 0 0 0 0 0 0 0 0 0
0 0 0 0 0 0 0 0 0 0
0 0 0 0 0 0 0 0 0 0
0 0 0 0 0 0 0 0 0 0
0 0 0 0 0 0 0 0 0 0
0 0 0 0 0 0 0 0 0 0
