8 8 -4 -4 -4 -4 -4 -4 8 8
8 8 7 7 7 7 7 7 8 8
8 8 7 7 7 7 7 7 7 -2
8 8 7 7 7 7 7 7 7 -2
8 8 7 7 7 7 7 7 7 -2
8 8 7 7 7 7 7 7 7 -2
8 8 7 7 7 7 7 7 7 -2
8 8 7 7 7 7 7 7 7 -2
8 8 8 8 8 8 8 8 8 8
8 8 8 8 8 8 8 8 8 8
0 0 0 0 0 0 0 0 0 0
1 10 0 0 0 0 0 0 0 0
0 0 0 0 0 0 0 0 0 0
10 8 0 0 0 0 0 0 0 0
0 0 0 0 0 0 0 0 0 0
0 0 0 0 0 0 0 0 0 0
0 0 0 0 0 0 0 0 0 0
0 0 0 0 0 0 0 0 0 0
0 0 0 0 0 0 0 0 0 0
