8 8 8 8 8 8 8 8 8 8
8 8 8 8 8 8 8 8 8 8
8 8 7 7 7 7 7 7 7 -1
8 8 7 7 7 7 7 7 7 -1
8 8 7 7 7 7 7 7 7 -1
8 8 7 7 7 7 7 7 7 -1
8 8 7 7 7 7 7 7 7 -1
8 8 7 7 7 7 7 7 7 -1
8 8 7 7 7 7 7 7 8 8
8 8 -3 -3 -3 -3 -3 -3 8 8
1 10 0 0 0 0 0 0 0 0
0 0 0 0 0 0 0 0 0 0
10 1 0 0 0 0 0 0 0 0
0 0 0 0 0 0 0 0 0 0
0 0 0 0 0 0 0 0 0 0
0 0 0 0 0 0 0 0 0 0
0 0 0 0 0 0 0 0 0 0
0 0 0 0 0 0 0 0 0 0
0 0 0 0 0 0 0 0 0 0
